10111111
11101001
10011011
11010010
01011011
11101000
10001111
11011001
