10101111
11100101
10110111
11001011
10011001
11010011
01101110
00111011