11101111
00101001
11111011
10100110
10110010
10011011
10110010
11010111